#######
#     #
# OXO #
# XPX #
# OXO #
#     #
#######
