############
#         O#
# P     ####
#           
#######    #
#O  ##     #
#   ##     #
#          #
#       XX #
#       #  #
############
