############
#        O #
# P     ####
#          #
#######    #
# O ##     #
#   ##     #
#          #
#   s    XX#
#       #  #
############